F 97,247,67
NO ./tests/resources/textures/north.xpm
SO ./tests/resources/textures/south.xpm
WE ./tests/resources/textures/west.xpm
EA ./tests/resources/textures/east.xpm
C 235,115,115

1111111
100*001
100S001
1000001
1111111
