F 97,247,67
NO ./tests/resources/textures/north.xpm
SO ./tests/resources/textures/south.xpm
WE ./tests/resources/textures/west.xpm
EA ./tests/resources/textures/east.xpm
C 235,115,115

111111111
111100001
100001111
100000
1S0001
111111