F 97,247,67
NO ./textures/greystone.xpm
SO ./textures/greystone.xpm
WE ./textures/greystone.xpm
EA ./textures/greystone.xpm
C 235,115,115

        1111111111111111111111111
        1000000000110000000000001
        1011000001110000000000001
        1D11000000D00000000000001
111111111011000001110000000000001
100000000011000001110111111111111
11110111111111011100000010001
11110111111111D111D1D1001M0001
11000000110101011100000010P01
100000000000000000000000D00L1
100000000000000011010100100L1
11000001110101011111011110N0111
11110111 1110101 101111010001
11111111 1111111 111111111111