F 97,247,67
NO ./textures/test/north.xpm
SO ./textures/test/south.xpm
WE ./textures/test/west.xpm
EA ./textures/test/east.xpm
C 235,115,115

111111
    100001
100001
10S001
100001
111111