F 97,247,67
NO ./textures/amongus.xpm
SO ./textures/amongus.xpm
WE ./textures/jib.xpm
EA ./textures/jib.xpm
C 235,115,115

a111111
1100N1
111111