F 97,247,67
NO ./textures/test/north.xpm
SO ./textures/test/south.xpm
WE ./textures/test/west.xpm
EA ./textures/test/east.xpm
C 235,115,115

  111111111111111111
 110000000E0000000011
1110000000000000000111
 11000001111100000011
  111111     1111111