F 97,247,67
NO ./textures/test/north.xpm
SO ./textures/test/south.xpm
WE ./textures/test/west.xpm
EA ./textures/test/east.xpm
C 235,115,115

  111111111111111111
 11D101D10E0000000D11
1110000000000100001111
 11D11D111111D0000011
  111111     1111111