NO textures/test/north.xpm
SO textures/test/south.xpm
WE textures/test/west.xpm
EA textures/test/east.xpm

F 20,20,20
C 200,200,200

1111111
1D1D1D1
1000001
110N001
1D00001
11001D1
1111111
